11111111111111111111111
10022000000000022000001
10022000220800022004001			
10000000000022000000001
10011022111111100110001
10011000100001100110001
10011000002200000022001
10011003002200000022001
12221100002200022222221
10000000002200000000001
10001100222222222222001
12222000002200000000001
11111111111111111111111
